....................
....................
....................
X...................
~##....A..B..B......
.......#######......
....................
....................
..................##
....................
............#:#.....
....................
.......###..........
1...................
###.................    
