....................
..........X.........
.......------.......
...--..........--...
..G..............G..
####..G.G.G.G....###
.......G.G.GBG......
......--------......
...--...........--..
....................
AG.G.B..............
##########..........
....................
.1..GGGGGGGG..GGGAGG
#############.######
