....................
.......G...G...G...G
.X..................
---....-...-...-...-
.......#............
..--...#.....G..G...
.......#...........-
GBGGBGG#GG...-..-...
##########..........
GG..................
GG...G.G......--....
--...####....GB.G...
....-#.......----...
1....#GGGG..........
##########..........
