....................
.........G...G......
.........#...#......
..................G.
..................#.
X............G......
..1..........#......
####..............G.
..................#.
.............G......
.............#......
..................G.
..................#.
G....G....GBG.G.....
#....#....#####.....



