....................
....................
....................
...GGG...........G..
...::#:::#::::#..:..
.-..................
....................
.-..................
....................
.-..................
....................
.-..................
......G........G..X.
.1....:....:...:..#.
##..................
