....................
.....GGGG..........X
.........B....#....-
.....-----..........
.........G..........
GGG.................
###.....G...G.......
.......#.....#......
....................
.................---
.....G.....G........
...................G
...G...G.G...G.....#
1.G.....G.....G.....
###.....#.....#.....
