....................
....................
....................
....................
.1..................
#########.##########
......#..G...#......
GGGGG.#..G...#.GGGGG
-----.#..G...#.-----
GGGGG.#..G...#.GGGGG
-----.#..G...#.-----
GGGGG.#..G...#.GGGGG
-----....G.....-----
.B.A.B...X....A.B.A.
######.######.######
