....................
....................
....................
......A...B......X..
......#####......#..
-...................
...................-
....................
-.................G.
..................-.
1...................
######..............
..................G.
GGGGGG............#.
######...#..#.......
....................
